111111111111111111111111111111111111111111111
100000000011111000000C00000001111110000000001
101111100011001111111011111101000110000000001
10000C1P00000000C0000100000000001111111100011
111110111101111110111110111111110C00000010001
100000000100000010000010000C00001111111001001
100011111101111011101010111110010C00001001001
100C10000000000C10100000001001110001001001001
100010111111101110C01001111001000010001001111
100010100000001000100000001001111010001000001
100010101111101111101110C00001010001110110001
100010000001000000000010011100010100000C00001
101110111101011111110010000100C01011111011001
1C0000000001000C00000000001010001000001001001
111101111101111101111C10001010001011111001001
100000000001000001000000000000000C00000001001
1CE111101111101111101011111011111101110010001
100000000000000C000000000000000C0000000C00001
111111111111111111111111111111111111111111111