111111111111111111111111111111111111111111111
1P0000000000000000000000000000000000000000001
101111111C11111111111110011111111111111110001
100000001000000000000010C00000000000000010001
100000001001111111100010011111111110001010001
10001110100000001010001000000000001C001010001
10101C1010000C1000100010000000000011001011001
101010101001111110100011111100111010011011101
101010001000000010100C100011000C10100C1010001
101010001001111C10100000000101001011111010001
10C010001000000010100111100101001000000010001
100010001011111110100100100101101C10000010001
10001000101C00000010010010010C101110000C10001
100011111011111100100100100111101111111110101
10000000000000000C1001001001C0001000000010101
111111111100111111100100100111111000000010101
10000000C100100000000100100000000000001010101
10000000010010001111010011111111000000101C001
100011111100100000000100000000100000001010101
100000000000100000000100000000100000001010101
100000000011100011110111111000100000001010C01
1C000000000000000000000000000C100000001010E01
111111111111111111111111111111111111111111111
111111111111111111111111111111111111111111111