1111111111111111
1P000010000001E1
1C0C0C1000000111
1000111000000001
1011100000000001
1000000000000001
1000000C0C0C0C01
1111111111111111
