1111111111111111
1P00001000000001
1C0C0C1000000001
1000111000000001
1E11100000000001
1000000000000001
1000000C0C0C0C01
1111111111111111
