1111111111111111
1P000010000000E1
1C0C0C1000000001
1000111000000001
1011100000000001
1000000000000001
1000000C0C0C01X1
1111111111111111
